##########
#P......B#
#..E..E..#
#..#######
#..X.....#
#........#
#........#
#........#
#........#
##########