##########
#P......B#
#...E...E#
#..#######
#..X.....#
#........#
#........#
#....S...#
#..Q.....#
##########