##########
#P......B#
#........#
#..#######
#..X.....#
#........#
#..S.....#
#........#
#E......E#
##########