##########
#I......O#
#..@....@#
#..#######
#..B.....#
#........#
#..S.....#
#........#
#E......E#
##########